# Conversions between hiragana and katakana
# =========================================
#
# Fields: hiragana, katakana
#

あいうえお	アイウエオ
かきくけこ	カキクケコ
がぎぐげご	ガギグゲゴ
さしすせそ	サシスセソ
ざじずぜぞ	ザジズゼゾ
たちつてと	タチツテト
だぢづでど	ダヂヅデド
なにぬねの	ナニヌネノ
はひふへほ	ハヒフヘホ
ばびぶべぼ	バビブベボ
ぱぴぷぺぽ	パピプペポ
まみむめも	マミムメモ
らりるれろ	ラリルレロ
わゐゑをん	ワヰヱヲン
やゆよ	ヤユヨ

ゝ	ヽ
ゞ	ヾ

ゐ	ヰ
ゑ	ヱ
ゔ	ヴ

# Small kana
ぁ	ァ
ぃ	ィ
ぅ	ゥ
ぇ	ェ
ぉ	ォ
っ	ッ
ゃ	ャ
ゅ	ュ
ょ	ョ
ぁぃぅぇぉっゃゅょゎゕゖ	ァィゥェォッャュョヮヵヶ

# Rare and weird
ゔゝゞわ゙ゐ゙ゑ゙を゙	ヴヽヾヷヸヹヺ
