# Conversions from katakana
# ==========================
#
# Fields: katakana, hiragana, romaji
#

ティ	てぃ	ti
ディ	でぃ	di
ドゥ	どぅ	du

ヿ	こと	KOTO
ｰ	－	-

ヰ	ゐ	wi
ヱ	ゑ	we
ヴ	ゔ	vu

ハヽ	はゝ	haha
バヽ	ばゝ	baba
パヽ	ぱゝ	papa

ハヾ	はゞ	haba
バヾ	ばゞ	baba
パヾ	ぱゞ	papa

ハヽヽ	はゝゝ	hahaha
ハヾヽヾ	はゞゝゞ	habahaba

ヿヽ	ことゝ	kototo
ヿヾ	ことゞ	kotodo

#----[ Small kana ]------------------------------------------------------------#

ァ	ぁ	a
ィ	ぃ	i
ゥ	ぅ	u
ェ	ぇ	e
ォ	ぉ	o
ッ	っ	tsu
ャ	ゃ	ya
ュ	ゅ	yu
ョ	ょ	yo

ヮ	ゎ	wa
ヵ	ゕ	ka

# transliterate to romaji as "ka" (https://en.wikipedia.org/wiki/Small_ke)
ヶ	ゖ	ka

#----[ Rare/small katakana ]---------------------------------------------------#

𛀀	え	e

# those can only be converted to hiragana with a combining mark
ヷ	わ゙	va
ヸ	ゐ゙	vi
ヹ	ゑ゙	ve
ヺ	を゙	vo

# all weird ones
ヴヽヾヿ𛀀ヷヸヹヺ	ゔゝゞことえわ゙ゐ゙ゑ゙を゙
ㇰㇱㇲㇳㇴㇵㇶㇷㇸㇹㇺㇻㇼㇽㇾㇿ	くしすとぬはひふへほむらりるれろ

# small
ㇰ	く	ku
ㇱ	し	shi
ㇲ	す	su
ㇳ	と	to
ㇴ	ぬ	nu
ㇵ	は	ha
ㇶ	ひ	hi
ㇷ	ふ	fu
ㇸ	へ	he
ㇹ	ほ	ho
ㇺ	む	mu
ㇻ	ら	ra
ㇼ	り	ri
ㇽ	る	ru
ㇾ	れ	re
ㇿ	ろ	ro

#----[ General input ]---------------------------------------------------------#

シャギャツッジャーンナン　ンアンンザ　ｘｚｍ	shagyatsujjaan'nan n'an'nza xzm
