# Equivalence table
# ==================
#
# Direct equivalence table between hiragana, katakana, and romaji. This is not
# complete but represent all the plain mappings that are reversible. Additional
# and more advanced cases are represented in `input.in`.
#
# Fields: hiragana, katakana, romaji
#

#----[ Plain mappings ]--------------------------------------------------------#

ん	ン	n

あ	ア	a
い	イ	i
う	ウ	u
え	エ	e
お	オ	o
か	カ	ka
き	キ	ki
く	ク	ku
け	ケ	ke
こ	コ	ko
が	ガ	ga
ぎ	ギ	gi
ぐ	グ	gu
げ	ゲ	ge
ご	ゴ	go
さ	サ	sa
し	シ	shi
す	ス	su
せ	セ	se
そ	ソ	so
ざ	ザ	za
じ	ジ	ji
ず	ズ	zu
ぜ	ゼ	ze
ぞ	ゾ	zo
た	タ	ta
ち	チ	chi
つ	ツ	tsu
て	テ	te
と	ト	to
だ	ダ	da
ぢ	ヂ	di
づ	ヅ	du
で	デ	de
ど	ド	do
な	ナ	na
に	ニ	ni
ぬ	ヌ	nu
ね	ネ	ne
の	ノ	no
は	ハ	ha
ひ	ヒ	hi
ふ	フ	fu
へ	ヘ	he
ほ	ホ	ho
ば	バ	ba
び	ビ	bi
ぶ	ブ	bu
べ	ベ	be
ぼ	ボ	bo
ぱ	パ	pa
ぴ	ピ	pi
ぷ	プ	pu
ぺ	ペ	pe
ぽ	ポ	po
ま	マ	ma
み	ミ	mi
む	ム	mu
め	メ	me
も	モ	mo
や	ヤ	ya
ゆ	ユ	yu
よ	ヨ	yo
ら	ラ	ra
り	リ	ri
る	ル	ru
れ	レ	re
ろ	ロ	ro
わ	ワ	wa
ヲ	を	wo

#----[ Digraphs ]--------------------------------------------------------------#

いぇ	イェ	ye

きゃ	キャ	kya
きゅ	キュ	kyu
きぇ	キェ	kye
きょ	キョ	kyo

ぎゃ	ギャ	gya
ぎゅ	ギュ	gyu
ぎぇ	ギェ	gye
ぎょ	ギョ	gyo

くぁ	クァ	qua
くぃ	クィ	qui
くぇ	クェ	que
くぉ	クォ	quo

しゃ	シャ	sha
しゅ	シュ	shu
しぇ	シェ	she
しょ	ショ	sho

じゃ	ジャ	ja
じゅ	ジュ	ju
じぇ	ジェ	je
じょ	ジョ	jo

ちゃ	チャ	cha
ちゅ	チュ	chu
ちぇ	チェ	che
ちょ	チョ	cho

ぢゃ	ヂャ	dya
ぢゅ	ヂュ	dyu
ぢぇ	ヂェ	dye
ぢょ	ヂョ	dyo

にゃ	ニャ	nya
にゅ	ニュ	nyu
にぇ	ニェ	nye
にょ	ニョ	nyo

ひゃ	ヒャ	hya
ひゅ	ヒュ	hyu
ひぇ	ヒェ	hye
ひょ	ヒョ	hyo

びゃ	ビャ	bya
びゅ	ビュ	byu
びぇ	ビェ	bye
びょ	ビョ	byo

ぴゃ	ピャ	pya
ぴゅ	ピュ	pyu
ぴぇ	ピェ	pye
ぴょ	ピョ	pyo

ふぁ	ファ	fa
ふぃ	フィ	fi
ふぇ	フェ	fe
ふぉ	フォ	fo

みゃ	ミャ	mya
みゅ	ミュ	myu
みぇ	ミェ	mye
みょ	ミョ	myo

りゃ	リャ	rya
りゅ	リュ	ryu
りぇ	リェ	rye
りょ	リョ	ryo

# common digraphs for rare kana
うぃ	ウィ	wi
うぇ	ウェ	we
ゔぁ	ヴァ	va
ゔぃ	ヴィ	vi
ゔぇ	ヴェ	ve
ゔぉ	ヴォ	vo

#----[ Fullwidth ASCII ]-------------------------------------------------------#

０	０	0
１	１	1
２	２	2
３	３	3
４	４	4
５	５	5
６	６	6
７	７	7
８	８	8
９	９	9

# isolated consonants are mapped to full-width
Ｂ	Ｂ	B
Ｃ	Ｃ	C
Ｄ	Ｄ	D
Ｆ	Ｆ	F
Ｇ	Ｇ	G
Ｈ	Ｈ	H
Ｊ	Ｊ	J
Ｋ	Ｋ	K
Ｌ	Ｌ	L
Ｍ	Ｍ	M
Ｐ	Ｐ	P
Ｑ	Ｑ	Q
Ｒ	Ｒ	R
Ｓ	Ｓ	S
Ｔ	Ｔ	T
Ｖ	Ｖ	V
Ｗ	Ｗ	W
Ｘ	Ｘ	X
Ｙ	Ｙ	Y
Ｚ	Ｚ	Z
ｂ	ｂ	b
ｃ	ｃ	c
ｄ	ｄ	d
ｆ	ｆ	f
ｇ	ｇ	g
ｈ	ｈ	h
ｊ	ｊ	j
ｋ	ｋ	k
ｌ	ｌ	l
ｍ	ｍ	m
ｐ	ｐ	p
ｑ	ｑ	q
ｒ	ｒ	r
ｓ	ｓ	s
ｔ	ｔ	t
ｖ	ｖ	v
ｗ	ｗ	w
ｘ	ｘ	x
ｙ	ｙ	y
ｚ	ｚ	z

#----[ Symbols & punctuation ]-------------------------------------------------#

-	－	－

・	・	/
、	、	,
。	。	.
「	「	[
」	」	]
《	《	«
》	》	»
！	！	!
＂	＂	"
＃	＃	#
＄	＄	$
％	％	%
＆	＆	&
＇	＇	'
（	（	(
）	）	)
＊	＊	*
＋	＋	+
：	：	:
；	；	;
＜	＜	<
＝	＝	=
＞	＞	>
？	？	?
＠	＠	@
＼	＼	\\
＾	＾	^
＿	＿	_
｀	｀	`
｛	｛	{
｜	｜	|
｝	｝	}
～	～	~

# Monetary symbols
￠	￠	¢
￡	￡	£
￢	￢	¬
￣	￣	¯
￥	￥	¥
￦	￦	₩
